1111111111111111111111111111111111111111
1000000000000000000000000000000000000001
1000000000000011000000011000000000000001
1001100011000110000000000000110000011001
1001100000110000000000000000110000011001
1000000000000000000000110000000000000001
1000000000000000000000110000000000000001
1000000000000000110000110000000000000001
1000000000000000110000110000000000000001
1000011111000000110000000000001111100001
1000011111000000110000000000001111100001
1000000000000000000000000000000000000001
1000000000000000000000000000000000000001
1000000000000110000000000110000000000001
1000000000000110000000000110000000000001
1000011000000000000000000000000001100001
1000011000000000000000000000000001100001
1000000000000000000110000000000000000001
1000000000000000000110000000000000000001
1000000000000000000000000000000000000001
1000000000100000000000000000001000000001
1000000000000000001111000000000000000001
1000000000000000001111000000000000000001
1000000000000000000000000000000000000001
1000000000001110000000000111000000000001
1000000000001110000000000111000000000001
1000000000000000000000000000000000000001
1000111111000000011111100000001111110001
1000000000000000000000000000000000000001
1000000000000000000000000000000000000001
1000000000000000110000110000000000000001
1000000000000000110000110000000000000001
1000000000000000000000000000000000000001
1000000000011000000000000011000000000001
1000000000000111000000011100000000000001
1000000000000000111111100000000000000001
1000000000000000000000000000000000000001
1000000000000000000200000000000000000001
1000000000000000000000000000000000000001
1111111111111111111111111111111111111111