1111111111111111111111111111111111111111
1100000000000111000000000010000001000001
1000000001111110000000000000000000000001
1000000000000010000111100000000000000001
1000000000000010000000010000001000100011
1000000100000001000000010000110001100001
1000000010000000111000010001000001000001
1000000010000000000000100010000001000001
1000000011000000000000000000000000000001
1000001100100000010000000000000000001001
1000010000010000001111111110000000001001
1000000000001000000000000001111111110001
1000000000000000000000000000000200000001
1111111111111111111111111111111111111111