0000000000000000000000000000001111111111
0000000000000000000000000000010000000001
0000000000000000000000000000100000000001
0000000000000001111111111111000000000001
0000000000000010000000000010000000000001
0000000000001100000000000100000000010001
0000011111110000000000000100000000010001
0000100000000000001000000000000000100001
0001000000000000001000000000000000100001
0010000111000000111000000000000000100001
0100001000100001111111111111111111000001
1000001000100010000000000000000010000001
1000001000100100000000000000000000000001
1000001001000100000000000000000000000001
1000001010000100001111111111100000000001
1000000100000100001000000000111111111111
1000000000000100001000000000100000000001
1000000000000100000000000000100000000001
1000000000000100000000010000100000000001
1000011111111100000000010000100000000001
1000000000000111111111110000100000100001
1000000000000000000000010000100000100001
1000000000000000000000010000100000100001
1111111111000000000000010000100000100001
1000000000000000000000010000100000100001
1000000000000000000000010000000000100001
1000000000000000000000010000000000100001
1000000000000011111111111111111111100001
1000000000000000000200000000000000000001
1111111111111111111111111111111111111111